d	d	d	d	d	d	d	d	d	d	d	d	d	d	d	d	d	d	d	d	d	d	d	d	d	d	d	d	d	d	d	d	r	r	r	r	r	d	d	d	d	d	d	d	d	d	d	d	d	d	d	d
d	d	d	d	d	d	d	d	d	d	d	d	d	d	d	d	d	d	d	d	d	d	d	d	d	d	d	d	d	d	d	r	r	r	r	r	r	r	d	d	d	d	d	d	d	d	d	d	d	d	d	d
d	d	d	d	d	d	d	d	d	d	d	d	d	d	d	d	d	d	d	d	d	d	d	r	d	d	d	d	d	d	d	r	r	r	r	r	r	r	d	d	d	d	d	d	d	d	d	d	d	d	d	d
d	d	d	d	d	d	d	d	d	d	d	d	d	d	d	d	d	d	d	d	d	d	d	r	d	d	d	d	d	d	d	r	r	r	d	d	r	r	d	d	d	d	d	d	d	d	d	d	d	d	d	d
d	d	d	d	d	d	d	d	d	d	d	d	d	d	d	d	d	d	d	d	d	d	d	r	d	d	d	d	d	d	d	r	r	d	d	d	r	r	d	d	d	d	d	d	d	d	d	d	d	d	d	d
d	d	d	d	d	d	d	d	d	d	d	d	d	d	d	d	d	d	d	d	d	d	r	r	b	b	b	b	b	b	b	r	r	r	r	r	r	r	d	d	d	d	d	d	d	d	d	d	d	d	d	d
d	d	d	d	d	d	d	d	d	d	d	d	d	d	d	d	d	d	d	d	d	d	d	r	b	b	b	b	b	b	b	r	r	r	r	r	r	r	d	d	d	d	d	d	d	d	d	d	d	d	d	d
d	d	d	d	d	d	d	d	d	d	d	d	d	d	d	d	d	d	d	d	d	d	b	b	b	b	b	b	b	b	b	b	r	r	r	r	r	b	d	d	d	d	d	d	d	d	d	d	d	d	d	d
d	d	d	d	d	d	d	d	d	d	d	d	d	d	d	d	d	d	r	d	d	b	d	b	b	b	b	b	b	b	b	b	r	r	r	r	r	b	b	b	d	d	d	d	d	d	d	d	d	d	d	d
d	d	d	d	d	d	d	d	d	d	d	d	d	d	d	d	d	d	d	d	d	d	d	b	b	b	b	b	b	b	b	b	r	r	r	r	r	b	b	b	d	d	d	d	d	d	d	d	d	d	d	d
d	d	d	d	d	d	d	d	d	d	r	d	d	d	d	d	d	d	d	d	d	d	d	b	b	b	b	b	b	b	b	b	r	r	r	r	r	b	b	b	d	d	d	d	d	d	d	d	d	d	d	d
d	d	d	d	d	d	d	d	d	d	d	d	d	d	d	d	d	d	d	d	d	d	d	b	b	b	b	b	b	b	b	b	r	r	r	r	r	b	b	b	d	d	d	d	d	d	d	d	d	d	d	d
