0	0	0	0	0	0	0	0	0	0	0	0	0	0	0	0	0	0	0	0	7	7	7	2	2	2	2	2	2	2	2	2	7	7	7	7	7	2	2	2	1	1	1	1	1	1	1	1	1	1	1	1
0	0	0	0	0	0	0	0	0	0	0	0	0	0	0	0	0	0	7	7	7	2	2	2	2	2	2	2	2	2	2	2	2	7	7	7	2	2	2	2	1	1	1	1	1	1	1	1	1	1	1	1
0	0	0	0	0	0	0	0	0	0	0	0	0	0	0	0	7	7	7	1	1	1	1	2	2	2	2	2	2	2	2	2	1	1	1	1	1	2	2	2	1	1	1	1	1	1	1	1	1	1	1	1
0	0	0	0	0	0	0	0	0	0	0	0	0	0	7	7	7	1	1	1	27	1	1	2	2	2	2	2	2	2	2	2	1	6	1	1	1	2	2	2	1	1	1	1	1	1	1	1	1	1	1	1
0	0	0	0	0	0	0	0	0	0	0	0	7	7	7	1	1	1	1	1	1	1	1	2	2	2	2	2	2	2	2	2	1	1	1	1	1	2	2	2	1	1	1	1	1	1	1	1	1	1	1	1
0	0	0	0	0	0	0	0	0	0	7	7	7	1	1	1	1	26	1	1	1	1	2	2	2	2	2	2	2	2	2	2	1	1	1	1	1	2	2	2	1	1	1	1	1	1	1	1	1	1	1	1
0	0	0	0	0	0	0	0	7	7	7	1	1	1	1	1	1	1	1	1	1	1	1	3	1	1	1	1	1	1	1	1	1	1	1	1	1	3	2	2	1	1	1	1	1	1	1	1	1	1	1	1
0	0	0	0	0	0	7	7	7	1	1	1	1	1	1	1	1	1	1	1	1	1	2	2	2	2	2	2	2	2	2	2	2	1	1	1	2	2	2	2	1	1	1	1	1	1	1	1	1	1	1	1
0	0	0	0	7	7	7	1	1	1	1	1	23	1	1	24	1	1	11	1	1	2	1	3	1	5	1	1	1	1	1	3	1	4	1	1	1	3	1	2	1	1	1	1	1	1	1	1	1	1	1	1
0	0	7	7	7	1	1	1	1	11	1	1	1	25	1	1	1	1	1	1	1	1	1	3	1	1	1	1	9	1	1	3	1	1	1	1	1	3	1	2	1	1	1	1	1	1	1	1	1	1	1	1
7	7	7	1	1	1	1	1	1	1	28	1	1	29	1	1	30	1	1	1	1	1	1	3	1	1	1	1	1	1	1	3	1	1	1	1	1	3	1	2	1	1	1	1	1	1	1	1	1	1	1	1
2	2	2	2	2	2	2	2	2	2	2	2	2	2	2	2	2	2	2	2	2	2	2	2	2	2	2	2	2	2	2	2	2	2	2	2	2	2	2	2	1	1	1	1	1	1	1	1	1	1	1	1
